1.常用命令git clone、git push、git add 、git commit、git checkout、git pull

2.创建仓库命令
git init	初始化仓库
git clone	拷贝一份远程仓库，也就是下载一个项目。

3.提交与修改
git add	添加文件到仓库
git status	查看仓库当前的状态，显示有变更的文件。
git diff	比较文件的不同，即暂存区和工作区的差异。
git commit	提交暂存区到本地仓库。
git reset	回退版本。
git rm	删除工作区文件。
git mv	移动或重命名工作区文件。

4.提交日志
git log	查看历史提交记录
git blame <file>	以列表形式查看指定文件的历史修改记录

5.远程操作
git remote	远程仓库操作
git fetch	从远程获取代码库
git pull	下载远程代码并合并
git push	上传远程代码并合并

6.git fetch和git pull的区别
